Aestuariimicrobium	Actinomycetota
Bacillus	Bacillota
Brachybacterium	Actinomycetota
Brevibacterium	Actinomycetota
Citricoccus	Actinomycetota
Citrobacter	Pseudomonadota
Corynebacterium	Actinomycetota
Dermabacter	Actinomycetota
Dermacoccus	Actinomycetota
Dietzia	Actinomycetota
Enterobacter	Pseudomonadota
Enterococcus	Bacillota
Escherichia	Pseudomonadota
Gordonia	Actinomycetota
Granulicatella	Bacillota
Helcococcus	Bacillota
Janibacter	Actinomycetota
Klebsiella	Pseudomonadota
Kocuria	Actinomycetota
Lysinibacillus	Bacillota
Microbacterium	Actinomycetota
Micrococcus	Actinomycetota
Micromonospora	Actinomycetota
Morganella	Pseudomonadota
Nesterenkonia	Actinomycetota
Niallia	Bacillota
Oceanobacillus	Bacillota
Paenibacillus	Bacillota
Paenibacillus_A	Bacillota
Peribacillus	Bacillota
Pseudoclavibacter	Actinomycetota
Raoultella	Pseudomonadota
Rhodocococcus	Actinomycetota
Rothia	Actinomycetota
Sphingobacterium	Bacteroidota
Staphylococcus	Bacillota
